5,6,5,5,5,5,5,5,5,5,5,5,5
5,0,0,0,0,0,0,0,0,0,0,0,5
5,0,0,0,0,8,0,8,0,0,0,0,5
5,0,0,2,0,0,0,0,1,0,0,0,5
5,0,0,0,0,1,1,0,1,0,0,0,5
5,0,0,0,0,0,1,0,1,0,0,0,5
5,0,0,1,0,0,0,0,0,0,0,0,5
5,0,0,1,1,0,4,4,4,0,0,0,5
5,0,0,0,0,0,4,4,4,0,0,0,5
5,0,0,0,0,0,4,4,4,0,0,0,5
5,0,0,0,0,0,0,0,0,0,0,0,5
7,0,0,0,0,0,0,0,0,0,0,0,5
5,5,5,5,5,5,5,5,5,5,5,5,5
