5,5,5,5,5,5,5,5,5,5,5,5,5
5,0,0,0,0,0,0,0,0,0,0,0,5
5,0,9,0,8,0,0,0,0,3,0,0,5
5,0,0,0,0,0,0,0,0,0,1,1,5
5,0,0,0,8,0,1,0,0,0,0,0,5
5,0,0,0,8,0,0,0,6,0,0,0,5
5,0,0,0,0,0,0,0,0,0,7,0,5
5,2,0,0,0,4,0,0,0,0,0,0,5
5,0,0,0,0,0,0,0,0,0,0,0,5
5,5,5,5,5,5,5,5,5,5,5,5,5
